1111111111111111111111
1CC1111000000C01E10101
1000000000000000P10001
1000V00000011000010001
1001111000011000V00111
1111111111111111111111