11111111111111111
1C1110000C10E10C1
100000010000P1001
10C1V000000000001
10111000111011111
100000011C0000001
11011001100111001
100C100C100111001
100011CC110111C11
11111111111111111