1111111111111111111111
1001111000000001E10101
1000000000000000P10001
1000000000011000010001
1001111000011000000111
1111111111111111111111