1111111111111111111111
1CC1111000000C01010101
10000000000E0000P10001
1000000000011000010001
1001111E00011000000111
1111111111111111111111