1111111111111111111111
1CC1111000000C01E10101
1000000000000000010001
1000000000011000010001
1001111000011000000111
1111111111111111111111