111111111111
1C0C1C0E10C1
100110001001
1011V0000001
100000111111
1000001C0001
110110001101
100C10101101
1P001C1011C1
111111111111