1111111111111111111111
1CC1111000000C01E10101
1000000000000000P10001
1000000000011000010001
100111100001100000011
1111111111111111111111